      ######
      #    #
      #o   #
      #om  #
      # p  #
#######o   #
#   m      #
#  m       #
#######    #
      ######