#######
#p    #
#  #mo#
#  m  #
#  o  #
#######