######
# pmo#
# m  #
# o  #
######