########
#o  m o#
#o mp m#
#o m#  #
###    #
  ######