######
# pmo#
#    #
#    #
######