#####
#o m#
#  o#
#   #
# m #
# p #
#####