########
#p####o#
#  m  o#
# #### #
#  m   #
#      #
########