##########
#   #    #
#    m  o#
####m#p o#
#    m  o#
#   #    #
##########